11111111111111111111
1P000000100000010001
1000010010010111E001
10000101100101011101
10011100000100000001
10111011110111101111
10100011100111000001
1010100000011C100111
10001011010000000111
11111111111111111111