11111111
10001C01
1001E001
1P011101
10000001
11111111