11111111
10000011
1000EC11
1P000001
10000011
11111011
11111111